111111111111111111111111111111
1P00000CE0C0000000000000000001
100000000000000000000000000001
100000000000000000000000000001
100C00000000000000000000000001
1000000000001S0000100000000001
100000000000000000000000000001
100C000000C0000000000000000001
100000000000000000000000000001
100000000000000000000000000001
100000000000000000000000000001
100000000000000000000000000001
100000000000000000000000000001
100000000000000000000000000111
100000000000000000000000000101
111111111111111111111111111111