111111111111111111111111111111
1P00000C0EC0000000000000000001
1000000C0000000000000000000001
100000000000000000000000000001
100C00000000000000000000000001
100000000000000000000000000001
100000000000000000000000000001
100000000000000000000000000001
1000000000C0000000000000000001
100000000000000010000000000001
100000000000000010000000000001
100000C00000000000000000000001
100000000000000000000000000001
100000000000000000000000000001
100000000000000000000000000001
111111111111111111111111111111
